{
    "levels": [
        {
            "width": 9,
            "height": 10,
            "data": [
                [0,0,0,0,1,0,0,0,0],
                [0,0,0,0,1,0,0,0,0],
                [0,0,0,0,1,0,0,0,0],
                [0,0,0,0,0,0,0,0,0],
                [0,0,0,0,1,0,0,0,0],
                [0,0,0,0,1,0,0,0,0],
                [0,0,0,0,2,0,0,0,0],
                [0,0,0,0,0,0,0,0,0],
                [0,0,0,0,0,0,0,0,0],
                [0,0,0,0,0,0,0,0,0]
            ],
            "start": [4, 0],
            "end": [4, 6]
        },
        {
            "width": 9,
            "height": 10,
            "data": [
                [0,0,0,0,1,0,0,0,0],
                [0,0,0,0,0,1,0,0,0],
                [0,0,1,0,1,0,0,0,0],
                [0,0,1,0,1,1,0,0,0],
                [0,0,0,1,0,0,0,0,0],
                [0,0,0,0,1,1,0,0,0],
                [0,0,0,1,0,1,0,0,0],
                [0,0,1,0,0,0,0,0,0],
                [0,0,1,0,0,0,0,0,0],
                [0,0,1,0,2,0,0,0,0]
            ],
            "start": [4, 0],
            "end": [4, 9]
        }
    ] 
}